11 7
6 8
xxxxxxxxxxx          
x  xxx   xx
x  x x    x
x  x      x
x  xx    xx   
x         x
xxxxxxxx xx        

