11 7
0 8
xxxxxxxx xx          
x    xx  xx
x  x     xx
x  xx     x
x  x  x   x   
x         x
xxxxxxxxxxx  


